NO ./t0.txt
SO ./t1.txt
WE ./t2.txt
EA ./t3.txt


F 220,100,0
C 225,30,0

1111111111111111111111111
1S00000000110000000000001
1011000001110000000000001
1001000000000000000000001
1111111110110000011100001
10000000001100000111000000000000000011111111
111101111111110111000000100011111
11110111111111011101010010001
11000000110101011100000010001
10000000000000001100000010001
1000000000000000110101001000001
110000011101010111110110000000111
11110111 1110101 101111010001
11111111 1111111 111111111111