NO ./t0.txt
SO ./t1.txt
WE ./t2.txt
EA ./t3.txt


F 220,100,0
C 225,30,0

1111111111
1S00000001
1000000001
1000000001
1000000001
1000000001
1000000001
1000000001
1000000001
1000000001
1111111111