NO ./test_maps/textures/t0.xpm
SO ./test_maps/textures/t1.xpm
WE ./test_maps/textures/t2.xpm
EA ./test_maps/textures/t3.xpm


F 220,100,0
C 225,30,0

1111111111
1000000001
1000000001
1000100001
1000000001
10000E0001
1000000001
1000000001
1000000001
1111111111