NO ./test_maps/textures/wood.xpm
SO ./test_maps/textures/redbrick.xpm
WE ./test_maps/textures/colorstone.xpm
EA ./test_maps/textures/mossy.xpm


F 139,69,19
C 10,15,60

11111111111111111
10000000000000001
10001000000000001
10000100000000001
100000100W0000001
10000001000000001
10000000100000001
10000000010000001
10000000000000001
11111111111111111


