NO ./test_maps/textures/bluestone.xpm
SO ./test_maps/textures/wood.xpm
WE ./test_maps/textures/redbrick.xpm
EA ./test_maps/textures/purplestone.xpm


F 220,100,0
C 225,30,0

  111111111111111111
 11000000000000000011
1110000000000N00000111
 11000001111100000011
  111111     1111111