NO ./test_maps/textures/t0.xpm
SO ./test_maps/textures/t1.xpm
WE ./test_maps/textures/t2.xpm
EA ./test_maps/textures/t3.xpm


F 220,100,0
C 225,30,0

  111111111111111111
 110000000S0000000011
1110000000000000000111
 11000001111100000011
  111111     1111111