NO ./test_maps/textures/mossy.xpm
SO ./test_maps/textures/mossy.xpm
WE ./test_maps/textures/mossy.xpm
EA ./test_maps/textures/mossy.xpm


F 115,115,115
C 57,57,57

1111111111
1000000111
1000011011
1000100001
1000000101
10000N0101
1000011001
1000100001
1000100001
1000000001
1111111111
